111111111111111
100001110000001
100001E10000001
100001010000001
100000010000011
10P00001000C001
111111111111111