111111111111111
1000011100001
100001C10000011
1000010100E0001
10000000000001
1000P000000C001
111111111111111