111111111111111
100001110000001
100001C10000001
1000010100E0001
100P00000000011
1000000W000C001
111111111111111