111111111111111
100001110000001
100001010000001
1000010100E0001
100000000000011
100P00000000001
111111111111111