111111111111111
100001110000001
100001C10000001
1000010100E0001
100000000000011
1000P000000C0011
111111111111111