111111111111111
100001110000001
10000101000E001
100001110000001
100000000000011
10P00001000C001
111111111111111