111111111111111
100001110000001
100001C10000001
1000010100E0001
1000000000000111
1000P000000C001
111111111111111