1111111111111111111111111111111111111111111111111111111111111111111111
1100000000000000000000000000000000000000000000000000000000000000000001
1100000000000000000000000000000000000000000000000000000000000000000001
11000C0000000000000000000000000000000000000000000000000000000000000001
1100000000000000000000000000000000000000000000000000000000000000000001
1100000000000000000000000000000000000000000000000000000000000000000001
110000000000000000000000000E000000000000000000000000000000000000000001
1100000000000000000000000000000000000000000000000000000000000000000001
1100000000000000000000000000000000000000000000000000000000000000000001
1100000000000000000000000000000000000000000000000000000000000000000001
1100000000000000000000000000000000000000000000000000000000000000000001
1100000000000000000000000000000000000000000000000000000000000000000001
110000000000000000000000000000000000000P000000000000000000000000000001
1100000000000000000000000000000000000000000000000000000000000000000001
1100000000000000000000000000000000000000000000000000000000000000000001
11000000000000000000000000000000000000000000000C0000000000000000000001
1100000000000000000000000000000000000000000000000000000000000000000C01
1100000000000000000000000000000000000000000000000000000000000000000001
1100000C00000000000000000000000000000000000000000000000000000000000001
1100000000000000000000000000000000000000000000000000000000000000000001
1100000000000000000000000000000000000000000000000000000000000000000001
1000000000000000000000000000000000000000000000000000000000000C00000001
1111111111111111111111111111111111111111111111111111111111111111111111