111111
1E0001
100P01
100001
10C001
111111