111111111111111
1000011100000E1
100001010000001
100001110000001
100000000000011
1000P000000C001
111111111111111