1111111111111111111
1000010000100011001
100000010000000PE01
1100000110001110001
1111111111111111111