111111111111111
100001110000001
100001P10000001
100001010000001
100000000000011
10000000000C001
111111111111111