101110101111111
1P0001110000001
1000010100E0001
011000000000010
10000001000C001
111111111111111