111111111111111
100001110000001
100001P10000001
1000011100E0001
100W00000000011
10000000000C001
111111111111111