111111111111111
100001110000001
100001P10000001
1000010100E0001
100W00010000011
10000001000C001
111111111111111