1111111111111111111
10000100C0100Q00001
10Q000010000P000E01
110000C1100C101C001
110C0000000110000C1
1111111111111111111