1111111111111111111
10000100C0100000001
100Q00010P00000QE01
110000C1100C101C0Q1
110C0000000110000C1
1111111111111111111