1111111111111111111
10000100C0100000001
100Q00010P00000QE01
110000C1100C101Q0C1
110C00000001100Q001
1111111111111111111